XXXXXXXXXX
XOOOOOOOOX
XOXOOOXXOX
XOOXOOXOOX
XOOOXOOXOX
XOOXOOOXXX
XXOOXOOOOX
XOOXOOXOOX
XOOXOOOXOX
XXXXXXXXXX